9
6
111111
100001
106101
100101
100101
100101
100901
100071
111111
